A                  #   
##### ###### #   # # # 
             # # # # # 
 ####### # # # # # # # 
         # # # # # # # 
 ######### # # # # # # 
           #   # #   # 
##### #### # # # # #   
           # # # # #   
 ######### # # # # ### 
               #       
##### ######## # ######
         #             
 # ##### # ######### # 
 #     # # #         # 
 # ### # # # ####### # 
 #     # # #         # 
 ##### # # # # ##### # 
           # # #       
 ####### # # # # ######
         #   #        B
