#############
#A  #     #B#
### # ### # #
#     # # # #
####### # # #
#       # # #
# ####### # #
#           #
#############