#############
#A        #B#
### # ### # #
#       # # #
####### # # #
#       # # #
# ######### #
#           #
#############